R 100000000 10000000
NO ./texture/1.xpm
SO ./texture/2.xpm
WE ./texture/3.xpm
EA ./texture/4.xpm
S ./texture/cat.xpm
F 2,121,219
C 122,122,122

1111111111111111111111111111111111111111111111111111111111111111111111111111111111111111111111111111111111111111111111111111111111111111111111111111111111111111111111111111111
 12222222222222222222222222222222222222222222222222222222222222222222222222222222222222222222222222222222222222222222222222222222222222222222222222222222222222222222222222221
 11222222222222222222222222222222222222222222222222222222222222222222222222222222222222222222222222222222222222222222222222222222222222222222222222222222222222222222222222211
  112222222222222222222222222222222222222222222222222222222222222222222222222222222222222222222222222222222222222222222222222222222222222222222222222222222222222222222222211
   1122222222222222222222222222222222222222222222222222222222222222222222221222222222222222222222222222222222222222222222222222222222222222222222222222222222222222222222211
    11222222222222222222222222222222222222222222222222222222222222222222222122222222222222222222222222222222222222222222222222222222222222222222222222222222222222222222211
     112222222222222222222222222222222222222222222222222222222222222222222212222222222222222222222222222222222222222222222222222222222222222222222222222222222222222222211
      1122222222222222222222222222222222222222222222222222222222222222222221222222222222222222222222222222222222222222222222222222222222222222222222222222222222222222211
       11222222222222222222222222222222222222222222222222222222222222211111122222222222222222222222222222222222222222222222222222222222222222222222222222222222222222211
        112222222222222222222222222222222222222222222222222222222222221222222222222222222222222222222222222222222222222222222222222222222222222222222222222222222222211
         1122222222222222222222222222222222222222222222222222222222222122222222222222222222222222222222222222222222222222222222222222222222222222222222222222222222211
          11222222222222222222222222222222222222222222222222222222222222222222222222222222211111111222222222222222222222222222222222222222222222222222222222222222211
           112222222222222222222222222222222222222222222222222222222222222222222222222222222222222222222222222222222222222222222222222222222222222222222222222222211
            1122222222222222222222222222222222222222222222222222222222222222222222222222222222222222222222222222222222222222222222222222222222222222222222222222211
            1122222222222222222222222222222222222222222222222222222222222222222222222222222222222222222222222222222222222222222222222222222222222222222222222222211
            1122222222222222222222222222222222222222222222222222222222222222222222222222222222222222222222222222222222222222222222222222222222222222222222222222211
            1122222222222222222222222222222222222222222222222222222222222222222222222222222222222222222222222222222222222222222222222222222222222222222222222222211
            1122222222222222222222222222222222222222222222222222222222222222222222222222222222222222222222222222222222222222222222222222222222222222222222222222211
            1122222222222222222222222222222222222222222222222222222222222222222222W22222222222222222222222222222222222222222222222222222222222222222222222222222211
            1122222222222222222222222222222222222222222222222222222222222222222222222222222222222222222222222222222222222222222222222222222222222222222222222222211
            1122222222222222222222222222222222222222222222222222222222222222222222222222222222222222222222222222222222222222222222222222222222222222222222222222211
            1122222222222222222222222222222222222222222111111111111111222222222222222222211111111112222222222222222222222222222222222222222222222222222222222222211
            1122222222222222222222222222222222222222222222222222222222222222222222222222222222222222222222222222222222222222222222222222222222222222222222222222211
            1122222222222222222222222222222222222222222222222222222222222222222222222222222222222222222222222222222222222222222222222222222222222222222222222222211
            1122222222222222222222222222222222222222222222222222222222222222222222222222222222222222222222222222222222222222222222222222222222222222222222222222211
            1122222222222222222222222222222222222222222222222222222222222222222222222222222222221112222222222222222222222222222222222222222222222222222222222222211
            1122222222222222222222222222222222222222222222222222222222222222222222222222222222222222222222222222222222222222222222222222222222222222222222222222211
            1122222222222222222222222222222222222222222222222222222222222222222222222222222222222222222222222222222222222222222222222222222222222222222222222222211
            1122222222222222222222222222222222222222222222222222222222222222222222222222222222222222222222222222222222222222222222222222222222222222222222222222211
            1122222222222222222222222222222222222222222222222222222222222222222222222222222222222222222222222222222222222222222222222222222222222222222222222222211
           112222222222222222222222222222222222222222222222222222222222222222222222222222222222222222222222222222222222222222222222222222222222222222222222222222211
          11222222222222222222222222222222222222222222222222222222222222222222222222222222222222222222222222222222222222222222222222222222222222222222222222222222211
          11111111111111111111111111111111111111111111111111111111111111111111111111111111111111111111111111111111111111111111111111111111111111111111111111111111111





